[Level 1]
[Solo]
................................
................................
................................
###############..###############
##............................##
##............................##
##............................##
##............................##
##............................##
##............................##
##.............1=.............##
##.............==.............##
####...##################...####
##............................##
##............................##
##............................##
##............................##
####...##################...####
##............................##
##............................##
##.....................Z=.....##
##.....................==.....##
####...##################...####
##............................##
##............................##
##.......M=...................##
##.......==...................##
################################
[End]
[Versus]
................................
................................
................................
###############..###############
##............................##
##............................##
##............................##
##............................##
##............................##
##............................##
##.............1=.............##
##.............==.............##
####...##################...####
##............................##
##............................##
##............................##
##............................##
####...##################...####
##............................##
##............................##
##.....................Z=.....##
##.....................==.....##
####...##################...####
##............................##
##............................##
##.......M=...................##
##.......==...................##
################################
[End]
[Coop]
................................
................................
................................
###############..###############
##............................##
##............................##
##............................##
##............................##
##............................##
##............................##
##.......1=..........2=.......##
##.......==..........==.......##
####...##################...####
##............................##
##............................##
##............................##
##............................##
####...##################...####
##............................##
##............................##
##.....................Z=.....##
##.....................==.....##
####...##################...####
##............................##
##............................##
##.......M=...................##
##.......==...................##
################################
[End]
[Level 2]
[Solo]
................................
................................
................................
###############..###############
##............................##
##.............1=.............##
##.............==.............##
##...........######...........##
##............................##
##............................##
##............................##
##............................##
##........####....####........##
##............................##
##............................##
##............................##
##............................##
##.....##################.....##
##............................##
##............................##
##....M=......................##
##....==......................##
##..######....####....######..##
##............................##
##............................##
##......................M=....##
##......................==....##
################################
[End]
[Versus]
................................
................................
................................
###############..###############
##............................##
##.............1=.............##
##.............==.............##
##...........######...........##
##............................##
##............................##
##............................##
##............................##
##........####....####........##
##............................##
##............................##
##............................##
##............................##
##.....##################.....##
##............................##
##............................##
##....M=......................##
##....==......................##
##..######....####....######..##
##............................##
##............................##
##......................M=....##
##......................==....##
################################
[End]
[Coop]
................................
................................
................................
###############..###############
##............................##
##............................##
##............................##
##...........######...........##
##............................##
##............................##
##.........1=......2=.........##
##.........==......==.........##
##........####....####........##
##............................##
##............................##
##............................##
##............................##
##.....##################.....##
##............................##
##............................##
##....M=......................##
##....==......................##
##..######....####....######..##
##............................##
##............................##
##......................M=....##
##......................==....##
################################
[End]
[Level 3]
[Solo]
.......|.....|....|.....|.......
.......|.....|....|.....|.......
.......|.....|....|.....|.......
########.....##..##.....########
##............................##
##............................##
##............................##
##............................##
##...########......########...##
##...#....................#...##
##...#..M=............M=..#...##
##...#..==............==..#...##
##...#########....#########...##
##...#....................#...##
##...#....................#...##
##...#....................#...##
##...#....................#...##
##...#########....#########...##
##............................##
##............................##
##............................##
##............................##
######...###........###...######
##............................##
##............................##
##.............1=.............##
##.............==.............##
#########...########...#########
[End]
[Versus]
.......|.....|....|.....|.......
.......|.....|....|.....|.......
.......|.....|....|.....|.......
########.....##..##.....########
##............................##
##............................##
##............................##
##............................##
##...########......########...##
##...#....................#...##
##...#..M=............M=..#...##
##...#..==............==..#...##
##...#########....#########...##
##...#....................#...##
##...#....................#...##
##...#....................#...##
##...#....................#...##
##...#########....#########...##
##............................##
##............................##
##............................##
##............................##
######...###........###...######
##............................##
##............................##
##.............1=.............##
##.............==.............##
#########...########...#########
[End]
[Coop]
.......|.....|....|.....|.......
.......|.....|....|.....|.......
.......|.....|....|.....|.......
########.....##..##.....########
##............................##
##............................##
##............................##
##............................##
##...########......########...##
##...#....................#...##
##...#..M=............M=..#...##
##...#..==............==..#...##
##...#########....#########...##
##...#....................#...##
##...#....................#...##
##...#....................#...##
##...#....................#...##
##...#########....#########...##
##............................##
##............................##
##............................##
##............................##
######...###........###...######
##............................##
##............................##
##..1=....................2=..##
##..==....................==..##
#########...########...#########
[End]